1111111111111111111111
111111111E111111111111
1000000000000000000001
1000000000000000000001
10010C0100101001001001
1000000000000000000001
1000000000000000000001
10010010010001C0100101
1000000000000000000001
1000000000000000100001
1001000100010010001001
1000C00000000000000001
1000000000000000000001
11111110P0001111111111
1111111000001111111111
1111111111111111111111
