1111111000001111111111
1111111000001111111111
0000000000000000000001
0000000000000000000001
1001000100001001001001
0000000000000000000000
0000000000000000000000
1001001001000100100100
0000000000000000000000
0000000000000000000000
1001000100010010001001
0000000000000000000001
0000000000000000000001
11111110P0111111111111
1111111000111111111111
