11111110001111111
11111110001111111
00000000000000001
10100010001010001
00000000000000000
10101010001010100
00000000000000000
10100010001010001
00000000000000001
11111110P01111111
11111110001111111
