1111111111111111111111
11111110000C1111111111
1000000000000000000001
1000000000000000000001
10010C0100001001001001
1000000000000000000001
1000000000000000000001
10010010010001C0100101
1000000000000000000001
1000000000000000000001
1001000100010010001001
1000000000000000000001
1000000000000000000001
11111110P0001111111111
1111111000001111111111
1111111111111111111111
