1111111111000
0000000000000
1000100000000
0000000000000
100010000P000
0000000000000
1000100000000
1111111111000
